148,145,157,182,211,194,161,174
167,145,144,152,172,175,162,161
178,167,159,150,156,162,155,150
163,166,170,162,156,158,155,149
115,123,153,166,165,161,157,168
125,126,152,169,175,175,174,173
192,174,172,181,188,204,200,180
182,171,176,180,181,194,194,176
