133,133,133,127,131,155,163,149
133,133,133,127,131,155,163,149
133,133,133,127,131,155,163,149
133,133,133,127,131,155,163,149
133,133,133,127,131,155,163,149
137,137,137,120,116,129,140,133
142,142,142,126,124,113,122,122
149,149,149,137,127,123,110,111
