132,136,132,122,127,149,160,148
130,135,133,120,126,155,168,153
127,133,134,125,130,154,163,149
131,137,137,128,134,157,166,151
132,135,132,121,127,151,162,150
131,133,129,118,117,131,140,136
136,142,142,131,120,117,116,119
139,146,148,141,129,118,112,115
