48,-55,70,-16,-24,0,0,0
-0,-36,14,0,0,-0,0,-0
0,39,-16,0,0,-0,-0,0
-14,-17,22,-0,-0,0,-0,-0
18,-0,-0,0,-0,0,0,-0
-0,-0,0,-0,0,-0,-0,0
0,0,0,0,-0,0,0,-0
0,-0,0,-0,0,-0,-0,0
