54,49,46,46,50,50,52,53
45,47,49,49,51,53,53,58
49,51,51,51,53,54,55,57
48,54,54,56,57,59,62,62
54,56,57,59,60,62,64,72
66,67,68,72,82,96,112,131
69,80,99,129,158,175,185,195
103,139,175,195,203,207,202,200
