-18,4,-5,1,-1,-0,-0,-0
-2,7,-1,1,-0,0,-0,0
4,-7,1,-1,0,-0,0,-0
-6,4,0,1,0,0,0,0
2,-0,-0,-0,-0,-0,-0,-0
-1,-0,0,0,0,0,-0,0
-0,0,-0,-0,-0,0,-0,0
-0,0,-0,0,0,0,-0,0
