-288,44,-50,16,-24,-0,-0,-0
-24,84,-14,19,-0,0,-0,0
56,-91,16,-24,0,-0,0,-0
-84,68,0,29,0,0,0,0
36,-0,-0,-0,-0,-0,-0,-0
-24,-0,0,0,0,0,-0,0
-0,0,-0,-0,-0,0,-0,0
-0,0,-0,0,0,0,-0,0
