96,84,82,78,82,85,80,88
83,70,75,72,74,78,72,81
80,71,86,86,84,86,83,91
87,77,84,81,81,81,76,86
97,83,79,75,80,83,75,84
83,70,77,83,94,106,109,112
83,82,114,131,140,157,171,160
112,124,156,171,172,182,192,175
