89,82,76,75,79,79,80,81
78,78,78,76,78,80,80,84
78,78,78,78,80,81,82,82
76,80,80,80,81,81,82,80
80,80,81,81,80,79,79,83
83,81,80,82,89,99,112,125
82,86,98,121,145,159,168,174
98,124,153,170,178,183,180,176
